WWWWWWWWWWWWWWWWWWWWWWWWWWWW
WGGGWWWWWWWWWWWWWWWWWGGGWWWW
WGGGWWWWWWWWGGGWWWWWWGGGWWWW
WWGWWWWGGGGGGPGWWWWWWGGGWWWW
WWGWWWWGWWWWGGGWWWWWWWGWWWWW
WWGGGGGGWWWWWWWWWWWWWWGWWWWW
WWGWWWWWWWWWWWWWWWWWWWGWWWWW
WWGWWWWWWWWWWWWWWWWGGGGGGGWW
WWGWWWWWWWWGGGGGWWWGGGGGGGWW
WWGGGGGGWWWGGGGGWWWGGGGGGGWW
WWWGWWWGWWWGGGGGWWWGGGGGGGWW
WWWGWWWGWWWWWGWWWWWWWWGWWWWW
WWGGGWWGWWWWWGWWWWWWWWGWWWWW
WWGGGWWGWWWWWGWWWWWWGGGGGWWW
WWGGGWWGWWWWWGWWWWWWGWWWGWWW
WWWWWWWGGGGGGGGGGGGGGWWWGWWW
WWWWWWWGWWWWWWWWWWWWGWWWGWWW
WWWWWWWGWWWWWWWWWWWWGWWWGWWW
WWGGGWWGWWGGGWWWWWGGGGWWGWWW
WWGGGGGGGGGGGWWWWWGGGGWWGWWW
WWGGGWWGWWGGGWWWWWGGGGWWGWWW
WWWWWWWGWWWWWWWWWWWWWWWWGWWW
WWWWWWWGWWWWWWGGGGGGGGGGGWWW
WWWWWWGGGGWWWWGWWWWWWWWWWWWW
WWWWWWGGGGWWWWGWWWWWWWWWWWWW
WWWWWWGGGGWWGGGGGWWWWWWWWWWW
WWWWWWWWWWWWGGEGGWWWWWWWWWWW
WWWWWWWWWWWWWWWWWWWWWWWWWWWW