XXXXXXXXXXXXXXXXXXXXXXXXXXXX
XXXXXXXXXXXXXXXXXXXXXXXXXXXX
XXXXXXXXXXXXXXXXXXXXXXXXXXXX
XXXCCCCCCCCCCCCCCCCCCCCCCXXX
XXXCXXXXXXXXXXXCXXXXXXXXCXXX
XXXCXXXXXXXXXXXCXXXXXXXXCXXX
XXXCXXCCCXCCCXCCCXCCCXXXCXXX
XXXCXXCCCCCCCXCCCXCCCXXXCXXX
XXXCXXCCCXCCCXCCCXCCCXXXCXXX
XXXCXXXXXXXCXXXCXXXCXXXXCXXX
XXXCXXCCCXXCXXXCXXXCXCCXCXXX
XXXCCCCCCCCCCCCCCCCCCCCXCXXX
XXXCXXCCCXXCXXXXXXXCXCCXCXXX
XXXCXXXCXXXCXXXXXXXCXXXXCXXX
XXXCXXCCCXCCCXCCCXCCCXXXCXXX
XXXCXXCCCXCCCCCCCXCCCXXXCXXX
XXXCXXCCCXCCCXCCCXCCCXXXCXXX
XXXCXXXCXXXXXXXCXXXXXXXXCXXX
XXXCXXCCCXXXXCCCCCXXCCCXCXXX
XXXCXXCCCXXXXCCCCCXXCCCXCXXX
XXXCXXXXXXXXXXXXXXXXXCXXCXXX
XXXCCCCCCCCCCCCCCCCCCCCCCXXX
XXXXXXCXXXXXXXCXXXXXXCXXXXXX
XXXXXXCXXXXXXXCXXXXXXCXXXXXX
XXXXCCCCCXXXCCCCCXXCCCCCXXXX
XXXXCCCCCXXXCCCCCXXCCCCCXXXX
XXXXCCCCCXXXCCCCCXXCCCCCXXXX
XXXXXXXXXXXXXXXXXXXXXXXXXXXX