GGWMFFMGAGGAFFGWGGGWGGGGFGWWMWAGMMGMAWGFGW
WGGAWMAAFGAGAWGGAGGFFAGFGGGFWGWGGMGGWGGGGA
FGAWGAAWFGGGGFAWGWWMGFAAGMWGGFGGFGMGMWGGGW
MAGGWFGGGGAGMAMAWAGGWAWMGMMAGWMFWGFGAGWAWA
GGGGMFWFFGMGWGAGGWAGGGGGGWWMGGFGGAMMGGGWGA
GAGGGGAWGMAGFGGGFGGAMGAGGGFAAGWGWGWFAGGGFM
FGGGGAWGGFWMGFWWMFGGGGGGAGGFGGGFGFMGAWAGGA
GAGMFAAAAGGWGFMWGGWGMAFAGGWAGFFAGGFFGFGGGG
MWGAWAGGAMWGGGGGFGFMGGMFGGGMAWFAMGFFAAGFGF
MGGAFMGFGGMGGMWFGFGAWFAAMMGGFAWGAGAGAFFGGF
AWAFGMGFGGAAGAGWFFMAWGMGWFGGGGGAFAGAGGWGGM
GMGFAWMGGAFGGGMGGGMGGFGGWFGGGFWGGAGGGGWAFG
GMWFGGGAGGGAGMAMFMGGGGGGGGGFAGGFGWGGGFWGGG
GMAGFGGGGFFMFAFWGGGGGGWFAGAFMGFGAFAGFFMWAG
WGGGFFGGFMGAGGGGGGGFFMFGAGGMAWAGWMGWWFFGAA
AGGGGAAGFGWMGGMFGFGMAFGGGAAGMFWAGAGFWAWGFA
MGGGGGFMMAGGGMWMGAFAMGWGFGGGFGAMAGFFGGFGGA
GFGGGGGGMAWGFGWGGGFGGGGMAAGGGGAGGGGAGFGGFG
AGGGGMFGAGGGFWGGGAGGAFAWWMGGAAGWGGGGFAGMFM
GGAMGAGGFGGWFFFGGGGGMGFGWMWAMWAGWGGAGMMGGG
GGFWGGGWGGGFGAMAGMMGGGAGGGAAGWMGGAGAMMAAAG
GGGMFGFWGFGWGAGFMAFGGGGAWAWAGGFGWGAWAGGGFF
FGGGMGGFFGMWGGFFGGMAGGMGWGFGFAAGGMGGAAMFGG
GGFGAGGAGWGGWWAFAFAWGWFAFGAMGAFGGGFGGGWGGF
FAGGWGWWGGGGGGGGAFAWAGAGWMAAGGGGAFMGGWWAGG
GAMMGAGFGAGGWAGGWGFWMAGFAGGWFGFGGAGGAAAWGG
WGMFFAGGMGWGGGMGAWFAFGGWMMMFGGGAGAAGMAFGGG
GAWMGGGGGFGMFWFGFGGGGAGGGFGGGFFGFGAWWAGMMF
GMMGMFGFMWGFMGWFGGGGFFMFFMAGGGFWAAAWAGMGFF
MGGGGAGGFGAGGFGGMGAGGAWGWGGGGFGGWMFGGAFGGG
GGMGGAFWMGAWFGGFGGGGAAFGGGGFAAGFGGGGAGFGGG
GMGGGFMFGGGGGWGAGAMAMGMWGGAFFWFGGGFGGGWFGW
GGGGFGGGMGGGMFFGGGFGWFFGGFGGGMGGFMGGGAFFGG
FGAFMFMGGAGMMMGGGGMGAMAWAGGAAMGGGGGGWGFFGM
GGWAGGFFGAAGGWFGGMGFGGGFFGFGFGFGGGGGMMGAGG
GGGFFWGGFWGGGGGFGFGGGFAGAGGGMGMGGGAAGGWGWW
AAAGAGFAGAGGGMGAGAGAFGGAWMAWMGGFGAAAAFFAFF
FGGGAAGGGGFFGAGGAGGAFWMAWFMAGAGAFMGMGFGGAM
MGWGAFGGFGAGAFGFMWGMMAGGAMWFWAGMGGGFGGGWGW
GAAGGGFGAFGFGAGGAGGMGGGGGFGWMGAGFMGMFGMGGG
GFAFGAGGAWMGGGGGGGGGGGGMGGGFGGWAGGGGWAGGWG
GAGGFAGFGAGMAAWGMGAGGGGGFGWGGGGGFGAGAAAGGG
