XXXXXXXXXXXXXXXXXXXXXXXXXXXX
XCCCXXXXXXXXXXXXXXXXXCCCXXXX
XCCCXXXXXXXXCCCXXXXXXCCCXXXX
XXCXXXXCCCCCCCCXXXXXXCCCXXXX
XXCXXXXCXXXXCCCXXXXXXXCXXXXX
XXCCCCCCXXXXXXXXXXXXXXCXXXXX
XXCXXXXXXXXXXXXXXXXXXXCXXXXX
XXCXXXXXXXXXXXXXXXXCCCCCCCXX
XXCXXXXXXXXCCCCCXXXCCCCCCCXX
XXCCCCCCXXXCCCCCXXXCCCCCCCXX
XXXCXXXCXXXCCCCCXXXCCCCCCCXX
XXXCXXXCXXXXXCXXXXXXXXCXXXXX
XXCCCXXCXXXXXCXXXXXXXXCXXXXX
XXCCCXXCXXXXXCXXXXXXCCCCCXXX
XXCCCXXCXXXXXCXXXXXXCXXXCXXX
XXXXXXXCCCCCCCCCCCCCCXXXCXXX
XXXXXXXCXXXXXXXXXXXXCXXXCXXX
XXXXXXXCXXXXXXXXXXXXCXXXCXXX
XXCCCXXCXXCCCXXXXXCCCCXXCXXX
XXCCCCCCCCCCCXXXXXCCCCXXCXXX
XXCCCXXCXXCCCXXXXXCCCCXXCXXX
XXXXXXXCXXXXXXXXXXXXXXXXCXXX
XXXXXXXCXXXXXXCCCCCCCCCCCXXX
XXXXXXCCCCXXXXCXXXXXXXXXXXXX
XXXXXXCCCCXXXXCXXXXXXXXXXXXX
XXXXXXCCCCXXCCCCCXXXXXXXXXXX
XXXXXXXXXXXXCCCCCXXXXXXXXXXX
XXXXXXXXXXXXXXXXXXXXXXXXXXXX